111111111111111111
100001000000000001
1000C0000000000001
100000000000000001
10000000P000000001
100000000000000101
100000000000000101
10000000E000001001
100000000000000101
100000000000000101
111111111111111111