11111111111
10000000001
10CE0000001
1000000P001
11111110111
11111111111
11111111111