11111111111111111111111111111111111111111111111111111111111111111111
10000000000000R0000000000000000000000000000000000000000L000000000001
10CE00000000000000000000000000000000000000R0000000000000000000000001
100000000000000000000000000000000000000000000000000P0000000000000001
11111111111111111111111111111111111111111111111111111111111111111111
